11111111111
1C00E00P101
11111111111
