1111111101
10P0100E01
100C000001
1111111101
