1111111111
10P0100E01
100C000000
1111111111
