1111111111111111111111111111111111
1000E0000000000C10000C000000000001
1010010100100010101001000000010101
1010010010101010101010000000101011
1P0000000C00C0101000000000000000C1
1111111111111111111111111111111111
