1111111111
10P0100E01
100C000001
1111111101
