1111111111
00P0100E01
100C000001
1111111111
