1111111111111111111111111111111111
1P00E0000000000C10000C001111111111
1111111111111111111111111111111111
