1111111111111111111111111111111111
1E00P00000000000100000000000000001
1111111111111111111111111111111111
