1111111111111
1P00000000001
1111111111101
1C00000000001
1011111111111
1000000000001
1111111111101
1E00000000001
1111111111111
