111111111111111
1P0000010000E01
111110111011101
1C0000010000001
101111111111101
100000000000001
111111111111111
