111111111111111
1P0C0C0C0C0CE1
100000000000001
1C0C0C0C0C0CC1
100000000000001
1C0C0C0C0C0CC1
111111111111111
