111111111111111
1P0000000000001
111111111111101
1E0000000000001
101111111111111
1C0000000000001
111111111111111
