111111111111111
1P0000000000C01
101111111111101
100000000000001
101111011111101
1000010E0000001
111111111111111
