11111111111111111111
1P0000000000000000C1
10000000000000000001
10000000000000000001
10000000000000000001
1C0000000000000000E1
11111111111111111111
