111111111111111
1P00001000000E1
101110010111101
100010000100001
101011111101101
1C0010000000C01
111111111111111
