1111111111111111111111111111111111
1C00E0000000000C10000C000000000001
1010010100100010101001000000010101
1010010010101010001010000000101011
1P0000000C00C010100000000C000000C1
1C0000000000000C10000C000000000001
1010001001000101010000000000101001
10100C0010101010001000000001010011
100000000C00C010100000000C000000C1
1111111111111111111111111111111111
1111111111111111111111111111111111
