1111111111111111111111111111111111
1C00E0000000000C10000C001111111111
1010010100100010101001000111111111
1010010010101010001010001111111111
1P0000000C00C010100000000111111111
1C0000000000000C10000C000111111111
1010001001000101010000000111111111
10100C0010101010001000000111111111
100000000C00C010100000000111111111
1111111111111111111111111111111111
