1111111111111111111111111111111111
1C00E00CCCCCC00C1CCC0C0CCCCCCCCC01
1010010100100010101001000000010101
1010010010101010001010000000101011
1P0000000C00C010100000000C000000C1
1111111111111111111111111111111111
