111111111111111111
1C00E0000000000C01
101001000010001001
1010000010C01000P1
10000C000010001001
101000001010101001
111111111111111111